-1  5 -1 4 -1
 3  2  4 5  3
-1  3 -1 3  3
 2 -1  5 4  3
-1 -1  3 5  5

7
6
4
10