-1  2 -1  3 -1
 4 -1  3 -1  3
-1  3 -1  4 -1
 4 -1  3 -1  4
-1  4 -1  5 -1

12
20
19
14