-1 -1  3  4  3
 4 -1 -1  4  3
 3  4 -1 -1  3
 5  4  4 -1 -1
 4  3  4  2 -1

12
20
19
14