 4  5  3  2  4
 3 -1 -1 -1  3
 1 -1 -1 -1  2
 2 -1 -1 -1  3
 1  6  3  5  5

3
1
9
2