5 3 4 1 2
4 3 4 2 1
3 4 2 1 5
3 2 4 5 3
1 2 3 2 2

11
8
5
1
3
4
17