-1 -1 -1 4 -1
 3  2 -1 2 -1
 3  2  1 3  3
 5  5  3 2  8
-1 -1 -1 4  5

5
8
4
14