-1  2  3  6 -1
 3 -1  5 -1  3
 4  5 -1  4  4
 5 -1  3 -1  5
-1  4  4  4 -1

25
16
20
18