5 4 2 1 3
4 1 1 2 3
4 3 2 1 3
3 2 4 5 3
4 3 2 2 1

4
2
11
6
8