3 4 2 2 3
5 3 2 4 6
3 6 3 4 6
3 4 6 7 4
3 5 7 2 3

10
4
12
17
24
6
11