2 2 2 2 2
3 4 3 2 3
4 5 6 4 3
1 2 4 3 5
3 3 3 3 3

2
3
6
14
5
4
12