5 3 2 1 3
1 2 3 4 2
1 2 4 2 1
2 4 2 5 6
3 3 3 2 1

10
6
7
5
4
1
3