7 4 2 4 5
5 6 7 8 8
6 4 5 7 4
6 5 7 4 7
7 5 7 5 7

1
14
21
25
23
31
30