3 4 5 6 5
4 5 4 5 4
4 5 4 3 4
3 4 5 4 4
5 5 6 4 4

20
21
22
24
27
23
16